Arch-Wiki	arch-wiki
LxAppearance	appearance
Reference Manager (Dmenu)	rporg
Wallpaper Manager	wallpaper
Zman (Man pages in Zathura)	zman
Font Manager	dmenu-fontviewer
Avahi Zeroconf Browser	/usr/bin/avahi-discover
Bluetooth Adapters	blueman-adapters
Bluetooth Manager	blueman-manager
Avahi SSH Server Browser	/usr/bin/bssh
Avahi VNC Server Browser	/usr/bin/bvnc
CMake	cmake-gui 
Foliate	com.github.johnfactotum.Foliate 
compton	compton
PacFinder	pacfinder
Manage Printing	/usr/bin/xdg-open http://localhost:631/
Firefox	/usr/lib/firefox/firefox 
Access Prompt	/usr/lib/gcr-prompter
View file	/usr/bin/gcr-viewer
GNU Image Manipulation Program	gimp-2.10 
GParted	/usr/bin/gparted 
HP Device Manager	hp-toolbox
hp-uiscan	/usr/bin/hp-uiscan
Htop	st -e htop
ipython	st -e ipython
Kvantum Manager	kvantummanager
Hardware Locality lstopo	lstopo
Customize Look and Feel	lxappearance
Monitor Settings	lxrandr
LXTerminal	lxterminal
mpv Media Player	mpv --player-operation-mode=pseudo-gui -- 
Gromit-MPX	gromit-mpx
Network	nm-applet
Advanced Network Configuration	nm-connection-editor
Neovim	st -e nvim 
FontForge	fontforge 
Archive Manager	file-roller 
Zathura	zathura 
Zathura	zathura 
Zathura	zathura 
Zathura	zathura 
PulseAudio Volume Control	pavucontrol
picom	picom
PolicyKit Authentication Agent	/usr/lib/polkit-gnome/polkit-gnome-authentication-agent-1
Qt5 Settings	qt5ct
Qt V4L2 test Utility	qv4l2
Qt V4L2 video capture utility	qvidcap
ranger	st -e ranger
sxiv	sxiv 
Bulk Rename	thunar --bulk-rename 
Thunar File Manager	thunar 
File Manager Settings	thunar-settings
Transmission	transmission-gtk 
uGet	uget-gtk 
XDvi	xdvi 
About Xfce	xfce4-about
